@@@@@*****####W
@@@@@*****####T
@@@@@*****####M
@@@@@*****#####
@@@*******#####
@@@*******#####
@@@*******#####
@@@@@@@@#######
@@@@@@@@#######
@@@@@@@@#######